......................................................................#......................................................................
.....................................................................#.#.....................................................................
....................................................................#.#.#....................................................................
...................................................................#.#.#.#...................................................................
..................................................................#.#.#.#.#..................................................................
.................................................................#.###.###.#.................................................................
................................................................#.#.###.#.#.#................................................................
...............................................................#.##.##.###.#.#...............................................................
..............................................................#.#.#.#.###.###.#..............................................................
.............................................................#.#.###.#.###.#.#.#.............................................................
............................................................#.###.###.#####.###.#............................................................
...........................................................#.#####.#.#.###.#####.#...........................................................
..........................................................#.#.###.#.###.###.#####.#..........................................................
.........................................................#.#.#.#.###.#.#.###.#####.#.........................................................
........................................................#.#.#.###.###.#.#.#.#.#####.#........................................................
.......................................................#.#.###.#.#.#.##.##.###.#.#.#.#.......................................................
......................................................#.#.###.#.###.###.#.#.##.##.#.#.#......................................................
.....................................................#.###.#.#.#.#.#.#.###.#.#.#.#.#.#.#.....................................................
....................................................#.####.##.##.#.#.##.#.#.##.#.##.###.#....................................................
...................................................#.#.#.#.###.#.#.#.#.#.###.#.#.#.#.#.#.#...................................................
..................................................#.###.#.#.##.##.#.##.#.###.##.##.#.##.#.#..................................................
.................................................#.###.#.###.#.#.###.#.#.#.#.###.#.#.##.##.#.................................................
................................................#.###.##.##.#.#.#.#.###.###.###.#.#.#.#.###.#................................................
...............................................#.#.#.#.#.###.#.#.#.#.#.#.###.##.##.###.#.#.#.#...............................................
..............................................#.#.#.#.##.##.#.#.##.#.#.##.#.#.#.#.###.#.##.##.#..............................................
.............................................#.###.#.#.#.###.##.##.#.#.#.#.#.#.###.###.#.#.###.#.............................................
............................................#.#.###.#.#.#.#.###.#.#.#.##.##.##.####.#.#.#.###.#.#............................................
...........................................#.##.##.###.##.##.#.#.###.###.#.###.###.#.##.##.#.#.#.#...........................................
..........................................#.#.#.###.##.##.#.#.#.#.#.#.#.#.#.#.#####.#.#.#.#.###.#.#..........................................
.........................................#.#.###.#.#.#.###.#.#.##.#.##.###.#.#####.#.#.###.#.#.###.#.........................................
........................................#.#.#.#.#.###.#.#.#.#.#.#.#.###.#.#.###.#.#.#.####.##.#.#.#.#........................................
.......................................#.#.##.##.#.#.#.##.##.#.#.#.###.#.#.#.##.#.##.#####.#.#.#.#.#.#.......................................
......................................#.#.#.#.###.###.###.#.#.#.#.####.#.##.#.#.#.#.###.#.#.#.###.#.#.#......................................
.....................................#.#.#.#.#.#.#.#.#.###.###.#.#.#.#.#.#.#.#.###.###.#.##.#.####.#.#.#.....................................
....................................#.#.#.#.##.#.##.###.#.###.#.#.##.#.##.##.##.#.#.#.###.#.#.#.###.###.#....................................
...................................#.#.#.#.#.#.#.###.###.####.#.##.#.#.#.#.#.###.#.#.###.##.##.#.#.#.###.#...................................
..................................#.#.###.###.###.#.#.##.####.#.#.###.#.#.#.#####.#.#.#.#.#.#.#.#.#.#.#.#.#..................................
.................................#.###.#.#.#.#####.#.###.####.##.#.#.###.#.#.#.#.#.#.###.#.#.###.###.#.#.#.#.................................
................................#.#.#.###.#.#.###.#.#.#.#.#.#.#.#.#.#.#.###.###.###.#.###.#.#.#.#.#.#.#.###.#................................
...............................#.#.###.###.#.#.#.#.##.#.##.#.###.###.###.###.##.##.#.#.#.#.#.###.#.#.##.##.#.#...............................
..............................#.#.#.#.#.#.#.#.#.#.#.#.#.#.###.#.#.###.###.###.#.#.#.#.#.###.#.#.#.###.#.###.#.#..............................
.............................#.#.##.##.#.##.#.##.#.#.###.#.#.#.#.#.#.#.##.###.##.#.#.#.#.#.#.##.#.##.###.#.#.#.#.............................
............................#.#.###.##.#.##.#.#.#.#.#.###.###.##.##.#.#.#.###.#.#.#.##.##.#.#.#.#.###.#.#.##.##.#............................
...........................#.#.#.###.#.#.###.#.#.#.#.#.#.#.#.#.#.#.###.##.##.###.#.###.###.#.###.#.#.#.#.###.###.#...........................
..........................#.##.##.#.###.#.#.#.#.#.###.###.#.#.###.####.##.###.###.#.#.###.#.###.#.#.#.#.#.#.#.#.#.#..........................
.........................#.###.###.###.#.###.#.#.#####.##.##.###.#.#.#.###.#.###.###.#.#.#.#.#.#.###.#.#.###.#.#.#.#.........................
........................#.#.###.#.#####.###.#.#.#.#####.#.#.#####.#.#.#.#.#.#####.#.#.###.#.##.##.#.#.#.#.###.##.##.#........................
.......................#.#.###.#.#.###.###.#.##.##.###.#.###.#.##.##.#.###.#.#.#.#.###.###.#.#.###.###.#.###.#.#.#.#.#.......................
......................#.#.#.#.#.###.#.#.#.#.#.#.#.#.#.###.#.#.###.###.#####.###.#.#.#.#.##.##.#.#.#.#.#.#.#.##.##.#.#.#......................
.....................#.#.###.#.#.#.###.#.#.#.#.#.###.#.#.##.##.#.#.#.###.#.###.#.#.##.#.##.#.#.##.##.#.#.#.#.#.##.##.#.#.....................
....................#.###.###.###.#.#.###.#.#.#.#.#.#.###.#.#.#.#.#.#.#.#.#.#.###.#.#.#.#.#.#.#.#.#.##.##.#.##.##.###.#.#....................
...................#.#.#.#.#.#.###.#.#.#.#.###.#.###.#.#.##.##.###.#.#.###.#.#.#.###.#.#.#.#.#.#.###.#.#.##.##.#.###.#.#.#...................
..................#.#.###.###.###.#.#.###.###.##.###.##.###.#.#.##.##.###.#.#.#.#.#.#.#.#.#.##.#.####.#.#.#.###.#.#.###.#.#..................
.................#.#.#####.##.####.###.#.#.###.#.#.#.###.#.#.#.###.##.##.#.##.#.##.#.#.#.#.#.#.#.#.##.##.#.###.#.###.###.#.#.................
................#.#.###.#.#.#.###.#.#.##.##.###.#.#.#.#.##.#.##.###.#.#.#.###.#.#.#.#.#.#.###.#.##.##.##.##.#.#.####.##.#.#.#................
...............#.#.#.##.#.##.#.#.#.#.#.#.#.#.#.#.##.##.#.#.#.#.###.#.#.#.#.#.#.#.#.#.###.#####.#.#.###.#.#.##.#.##.#.#.#.#.#.#...............
..............#.##.##.#.#.#.#.##.#.#.##.#.###.#.#.#.###.#.###.#.#.###.#.##.##.#.#.#.#.#.#####.###.#.###.#.###.#.#.###.#.#.###.#..............
.............#.#.#.#.#.##.##.###.#.#.#.#.#.#.###.#.#.#.###.#.#.#.#.###.#.#.#.#.#.##.##.###.#.#.##.#.###.#.##.#.###.#.#.#.###.#.#.............
............#.###.###.#.#.#.#.#.###.#.#.###.#.#.###.###.#.##.##.###.#.#.#.###.###.#.#.#.#.#.#.###.#.###.#.###.#.#.#.###.#####.#.#............
...........#.#.##.####.#.##.#.#.####.#.#.#.#.###.##.##.#.#.#.#.#.###.#.###.#.#.#.#.###.#.#.#.#.##.##.#.#.#.###.#.#.#.#.#.###.#.#.#...........
..........#.#.###.#.###.#.#.#.#.#.#.#.#.#.#.#####.#.#.#.#.#.#.###.###.###.#.#.#.#.#.#.#.#.###.#.#.#.###.##.##.#.#.#.#.###.#.#.#.#.#..........
.........#.#.#.#.#.#####.#.#.###.###.#.##.#.####.#.#.#.#.#.###.#.#.#.####.##.###.###.#.#.#.###.###.#.#.#.#.#.#.#.###.###.#.###.###.#.........
........#.#.#.#.#.###.###.#.#.#.#.#.#.#.#.#.#.#.#.###.#.###.#.#.#.#.#.###.#.#.##.##.#.###.###.#.#.#.#.#.###.#.#.#.#.#.###.#.###.#.#.#........
.......#.#.##.##.#.##.####.#.#.#.#.###.#.#.#.###.###.###.#.##.#.##.#.#.##.##.###.#.##.####.#.#.###.###.#.#.#.##.##.#.#####.#.#.#.###.#.......
......#.#.###.#.#.###.###.#.#.#.###.###.##.##.#.#####.###.###.#.###.#.#.#.#.###.#.###.#.#.##.#.##.###.#.#.#.#.#.#.##.#####.##.#.#.#.#.#......
.....#.#.#.#.#.#.#.#.#.#.#.#.#.#.#.###.#.#.#.#.#.###.#.#.#.###.#.###.#.#.#.#.#.#.#.##.##.###.#.#.#.##.##.##.##.##.##.###.#.##.##.#.#.#.#.....
....#.###.#.#.###.###.#.###.##.##.#.###.#.##.##.#.#.#.#.#.###.###.###.###.#.#.#.###.#.#.#.#.#.#.#.###.###.#.##.##.#.####.##.#.#.###.###.#....
...#.#####.#.#.##.###.##.#.###.##.#.###.##.#.#.#.#.#.#.#.###.#.#.#.###.##.#.##.#####.#.###.#.##.##.#.###.#.###.###.#.#.#.##.##.#.#.#.#.#.#...
..#.#.#.###.#.###.#.#.##.##.#.###.#.#.#.###.###.###.##.##.##.##.#.###.#.#.#.#.###.#.#.#.###.#.#.##.##.##.##.#.#.#.#.#.###.#.#.#.#.###.#.#.#..
.#.###.#.##.##.#.#.#.#.#.#.#.###.###.#.#.#.#.#.#.#.#.#.#.###.##.#.##.#.#.#.###.##.#.##.#.#.#.#.#.#.###.#.#.#.#.#.#.##.####.###.###.###.###.#.
#.#.#.#.#.#.#.#.##.#.##.#.#.#.#.#.###.###.###.#.#.##.#.##.#.###.#.###.#.#.#.#.###.#.##.#.##.#.#.#.###.#.#.###.#.#.###.#.###.#.#.###.#.###.#.#